{
  "track": [
	"UIIIIIIIIIIIIIIIIIIIIIIIIIIIIO",
	"JBBBBBBBBBBBBBBBBBBBBBBBBBBBBL",
	"JBQWWWNWWWWWWWWWWWWWWWWWWWWRBL",
	"JBAFSSPSSSSSSSSSSSSSSSSSSSEDBL",
	"JBADBBBBBBBBBBBBBBBBBBBBBBADBL",
	"JBADBBBBBBBBBQWWWWWRBBBBBBADBL",
	"JBADBBBBBBBBBAFSSSEDBBBBBBADBL",
	"JBADBBBBBBBBBADBBBADBBBBBBADBL",
	"JBADBBBBBBBBBADBBBADBBBBBBADBL",
	"JBADBBBBBBBBBADBBBAMWWWWWWCDBL",
	"JBADBBBBBBBBBADBBBZSSSSSSSSVBL",
	"JBADBBBBBBBBBADBBBBBBBBBBBBBBL",
	"JBAMWWWWWWWWWCMWWWWWWWWWWWWRBL",
	"JBZSSSSSSSSSSEFSSSSSSSSSSSEDBL",
	"JBBBBBBBBBBBBADBBBBBBBBBBBADBL",
	"JBBBBBBBBBBBBADBBBBBBBBBBBADBL",
	"JBBBBBBBBBBBBADBBBBBBBBBBBADBL",
	"JBBBBBBBBBBBBADBBBBBBBBBBBADBL",
	"JBBBBBBBBBBBBADBBBBBBBBBBBADBL",
	"JBBBBBBBBBBBBADBBBBBBBBBBBADBL",
	"JBBBBBBBBBBBBADBBBBBBBBBBBADBL",
	"JBBBBBBBBBBBBADBBBBBBBBBBBADBL",
	"JBBBBBBBBBBBBADBBBBBBBBBBBADBL",
	"JBBBBBBBBBBBBADBBBBBBBBBBBADBL",
	"JBBBBBBBBBBBBADBBBBBBBBBBBADBL",
	"JBBBBBBBBBBBBADBBBBBBBBBBBADBL",
	"JBBBBBBBBBBBBAMWWWWWWWWWWWCDBL",
	"JBBBBBBBBBBBBZSSSSSSSSSSSSSVBL",
	"JBBBBBBBBBBBBBBBBBBBBBBBBBBBBL",
	"GKKKKKKKKKKKKKKKKKKKKKKKKKKKKH"],
  "entities": [
  	"BBBBBBBBBBBBBBBBBBBBBBBBBBBBBB",
	"BBBBBBBBBBBBBBBBBBBBBBBBBBBBBB",
	"BBTTaTTTTTTTTTaTTTTTTTTTTaTTBB",
	"BBTTbTTTTTTTTTbTTTTTTTTTTbTTBB",
	"BBghBBBBBBBBBBBBBBBBBBBBBBcdBB",
	"BBTTBBBBBBBBBTTeTeTTBBBBBBTTBB",
	"BBTTBBBBBBBBBTTfTfTTBBBBBBcdBB",
	"BBghBBBBBBBBBcdBBBghBBBBBBTTBB",
	"BBTTBBBBBBBBBTTBBBghBBBBBBcdBB",
	"BBTTBBBBBBBBBTTBBBTTeTTTTeTTBB",
	"BBTTBBBBBBBBBTTBBBTTfTTTTfTTBB",
	"BBghBBBBBBBBBTTBBBBBBBBBBBBBBB",
	"BBTTeTTTTTTTecdeTTTTTTTTTeTTBB",
	"BBTTfTTTTTTTfcdfTTTTTTTTTfTTBB",
	"BBBBBBBBBBBBBcdBBBBBBBBBBBghBB",
	"BBBBBBBBBBBBBTTBBBBBBBBBBBTTBB",
	"BBBBBBBBBBBBBTTBBBBBBBBBBBTTBB",
	"BBBBBBBBBBBBBTTBBBBBBBBBBBTTBB",
	"BBBBBBBBBBBBBcdBBBBBBBBBBBghBB",
	"BBBBBBBBBBBBBTTBBBBBBBBBBBTTBB",
	"BBBBBBBBBBBBBTTBBBBBBBBBBBTTBB",
	"BBBBBBBBBBBBBTTBBBBBBBBBBBghBB",
	"BBBBBBBBBBBBBTTBBBBBBBBBBBTTBB",
	"BBBBBBBBBBBBBTTBBBBBBBBBBBTTBB",
	"BBBBBBBBBBBBBTTBBBBBBBBBBBTTBB",
	"BBBBBBBBBBBBBcdBBBBBBBBBBBghBB",
	"BBBBBBBBBBBBBTTaTTTTTTaTTaTTBB",
	"BBBBBBBBBBBBBTTbTTTTTTbTTbTTBB",
	"BBBBBBBBBBBBBBBBBBBBBBBBBBBBBB",
	"BBBBBBBBBBBBBBBBBBBBBBBBBBBBBB"],
	"npcInstructions": [
  	"BBBBBBBBBBBBBBBBBBBBBBBBBBBBBB",
	"BBBBBBBBBBBBBBBBBBBBBBBBBBBBBB",
	"BBRREEEEEKEEEEEEEEEEEEEEEERRBB",
	"BBRREEEEEKEEEEEEEEEEEEEEEERRBB",
	"BBNNBBBBBBBBBBBBBBBBBBBBBBSSBB",
	"BBNNBBBBBBBBBLLWWWLLBBBBBBSSBB",
	"BBNNBBBBBBBBBLLWWWLLBBBBBBSSBB",
	"BBNNBBBBBBBBBSSBBBNNBBBBBBSSBB",
	"BBNNBBBBBBBBBSSBBBNNBBBBBBSSBB",
	"BBNNBBBBBBBBBSSBBBRRWWWWWWRRBB",
	"BBNNBBBBBBBBBSSBBBRRWWWWWWRRBB",
	"BBNNBBBBBBBBBSSBBBBBBBBBBBBBBB",
	"BBRRWWWWWWWWWFFWWWWWWWWWWWLLBB",
	"BBRRWWWWWWWWWFFWWWWWWWWWWWLLBB",
	"BBBBBBBBBBBBBSSBBBBBBBBBBBNNBB",
	"BBBBBBBBBBBBBSSBBBBBBBBBBBNNBB",
	"BBBBBBBBBBBBBSSBBBBBBBBBBBNNBB",
	"BBBBBBBBBBBBBSSBBBBBBBBBBBNNBB",
	"BBBBBBBBBBBBBSSBBBBBBBBBBBNNBB",
	"BBBBBBBBBBBBBSSBBBBBBBBBBBNNBB",
	"BBBBBBBBBBBBBSSBBBBBBBBBBBNNBB",
	"BBBBBBBBBBBBBSSBBBBBBBBBBBNNBB",
	"BBBBBBBBBBBBBSSBBBBBBBBBBBNNBB",
	"BBBBBBBBBBBBBSSBBBBBBBBBBBNNBB",
	"BBBBBBBBBBBBBSSBBBBBBBBBBBNNBB",
	"BBBBBBBBBBBBBSSBBBBBBBBBBBNNBB",
	"BBBBBBBBBBBBBLLEEEEEEEEEEELLBB",
	"BBBBBBBBBBBBBLLEEEEEEEEEEELLBB",
	"BBBBBBBBBBBBBBBBBBBBBBBBBBBBBB",
	"BBBBBBBBBBBBBBBBBBBBBBBBBBBBBB"]
}