{
  "track": [
	"UIIIIIIIIIIIIIIIIIIIIIIIIIIIIO",
	"JBBBBBBBBBBBBBBBBBBBBBBBBBBBBL",
	"JBQWNWWRBBBBBBBBBBBBBBBBBBBBBL",
	"JBAFPSEDBBBBBBBBBBBBBBBBBBBBBL",
	"JBADBBAMWWWWRBQWWWWWWRQWWRBBBL",
	"JBADBBZSSSSEDBAFSSSSEDAFEDBBBL",
	"JBADBBBBBBBADBADQWWWCDADADBBBL",
	"JBADQWWWWWWCDBADAFSSSVADADBBBL",
	"JBADAFSSSSSSVBADADQWWWCDADBBBL",
	"JBADADBBBBBBBBADADAFSSSVADBBBL",
	"JBADAMWWWWWWWWCDADADQWWWCDBBBL",
	"JBADZSSSSSSSSSSVADADAFSSSVBBBL",
	"JBADQWWWWWWWWWWWCDADAMWWWRBBBL",
	"JBADAFSSSSSSSSSSSVADZSSSEDBBBL",
	"JBADAMWWWWWWWWWWWWCDQWWRADBBBL",
	"JBADZSSSSSSSSSSSSSSVAFEDADBBBL",
	"JBADQWWWWWWWWWWWWWWWCDADADBBBL",
	"JBADAFSSSSSSSSSSSSSSSVADADBBBL",
	"JBADAMWWWWWWWWWWWWWWWRADADBBBL",
	"JBADZSSSSSSSSSSSSSSSEDADADBBBL",
	"JBADQWWWWWWWWWWWWWWWCDADADBBBL",
	"JBADAFSSSSSSSSSSSSSSSVADADBBBL",
	"JBADAMWWWWWWWWWWWWWWWRADADBBBL",
	"JBADZSSSSSSSSSSSSSSSEDADADBBBL",
	"JBAMWWWWWWWWWWWWWWWWCDAMCDBBBL",
	"JBZSSSSSSSSSSSSSSSSSSVZSSVBBBL",
	"JBBBBBBBBBBBBBBBBBBBBBBBBBBBBL",
	"JBBBBBBBBBBBBBBBBBBBBBBBBBBBBL",
	"JBBBBBBBBBBBBBBBBBBBBBBBBBBBBL",
	"GKKKKKKKKKKKKKKKKKKKKKKKKKKKKH"],
  "entities": [
  	"BBBBBBBBBBBBBBBBBBBBBBBBBBBBBB",
	"BBBBBBBBBBBBBBBBBBBBBBBBBBBBBB",
	"BBBBBaBBBBBBBBBBBBBBBBBBBBBBBB",
	"BBBBBbBBBBBBBBBBBBBBBBBBBBBBBB",
	"BBBBBBBBaBBBBBBBBBaBBBBBBBBBBB",
	"BBBBBBBBbBBBBBBBBBbBBBBBBBBBBB",
	"BBBBBBBBBBBcdBBBBBBeBBghcdBBBB",
	"BBBBBBeBBBeBBBghBBBfBBBBBBBBBB",
	"BBghBBfBBBfBBBBBBBBBBaBBBBBBBB",
	"BBBBcdBBBBBBBBBBcdBBBbBBBBBBBB",
	"BBBBBBBBBaBBBBBBBBBBBBBeBBBBBB",
	"BBBBBBBBBbBBBBBBBBBBBBBfBBBBBB",
	"BBBBBBBeBBBBBBeBBBghBBaBBBBBBB",
	"BBBBBBBfBBBBBBfBBBBBBBbBBBBBBB",
	"BBBBBBaBBBBBBaBBBBBBBBBBBBBBBB",
	"BBBBBBbBBBBBBbBBBBBBBBBBcdBBBB",
	"BBghBBBeBBeBBBeBBBeBBBBBBBBBBB",
	"BBBBBBBfBBfBBBfBBBfBBBBBBBBBBB",
	"BBBBBBBaBBBBBaBBBBBaBBghBBBBBB",
	"BBBBBBBbBBBBBbBBBBBbBBBBBBBBBB",
	"BBBBBBBeBBBBeBBBBBBeBBBBBBBBBB",
	"BBBBBBBfBBBBfBBBBBBfBBBBcdBBBB",
	"BBghBBBaBBBBaBBBaBBBBBBBBBBBBB",
	"BBBBBBBbBBBBbBBBbBBBBBghcdBBBB",
	"BBBBBBBBBBeBBBBBBBeBBBBBBBBBBB",
	"BBBBBBBBBBfBBBBBBBfBBBBBBBBBBB",
	"BBBBBBBBBBBBBBBBBBBBBBBBBBBBBB",
	"BBBBBBBBBBBBBBBBBBBBBBBBBBBBBB",
	"BBBBBBBBBBBBBBBBBBBBBBBBBBBBBB",
	"BBBBBBBBBBBBBBBBBBBBBBBBBBBBBB"],
	"npcInstructions": [
	"BBBBBBBBBBBBBBBBBBBBBBBBBBBBBB",
	"BBBBBBBBBBBBBBBBBBBBBBBBBBBBBB",
	"BBRREERRBBBBBBBBBBBBBBBBBBBBBB",
	"BBRREERRBBBBBBBBBBBBBBBBBBBBBB",
	"BBNNBBLLEEERRBRREEEERRRRRRBBBB",
	"BBNNBBLLEEERRBRREEEERRRRRRBBBB",
	"BBNNBBBBBBBSSBNNLLWWRRNNSSBBBB",
	"BBNNLLWWWWWRRBNNLLWWRRNNSSBBBB",
	"BBNNLLWWWWWRRBNNSSRREELLSSBBBB",
	"BBNNSSBBBBBBBBNNSSRREELLSSBBBB",
	"BBNNLLEEEEEEEELLSSNNLLWWRRBBBB",
	"BBNNLLEEEEEEEELLSSNNLLWWRRBBBB",
	"BBNNLLWWWWWWWWWWRRNNLLEERRBBBB",
	"BBNNLLWWWWWWWWWWRRNNLLEERRBBBB",
	"BBNNLLEEEEEEEEEEEELLLLLLSSBBBB",
	"BBNNLLEEEEEEEEEEEELLLLLLSSBBBB",
	"BBNNLLWWWWWWWWWWWWWWRRNNSSBBBB",
	"BBNNLLWWWWWWWWWWWWWWRRNNSSBBBB",
	"BBNNLLEEEEEEEEEEEEEERRNNSSBBBB",
	"BBNNLLEEEEEEEEEEEEEERRNNSSBBBB",
	"BBNNLLWWWWWWWWWWWWWWRRNNSSBBBB",
	"BBNNLLWWWWWWWWWWWWWWRRNNSSBBBB",
	"BBNNLLEEEEEEEEEEEEEERRNNSSBBBB",
	"BBNNLLEEEEEEEEEEEEEERRNNSSBBBB",
	"BBRRWWWWWWWWWWWWWWWWRRRRRRBBBB",
	"BBRRWWWWWWWWWWWWWWWWRRRRRRBBBB",
	"BBBBBBBBBBBBBBBBBBBBBBBBBBBBBB",
	"BBBBBBBBBBBBBBBBBBBBBBBBBBBBBB",
	"BBBBBBBBBBBBBBBBBBBBBBBBBBBBBB",
	"BBBBBBBBBBBBBBBBBBBBBBBBBBBBBB"]
}