{
  "track": [
	"UIIIIIIIIIIIIIIIIIIIIIIIIIIIIO",
	"JBBBBBBBBBBBBBBBBBBBBBBBBBBBBL",
	"JBQWWWNWWWWWWWWWWWWWWWWWWWWRBL",
	"JBAFSSPSSSSSSSSSSSSSSSSSSSEDBL",
	"JBADBBBBBBBBBBBBBBBBBBBBBBADBL",
	"JBADBBBBBBBBBBBBBBBBBBBBBBADBL",
	"JBADBBBBBBBBBBBBBBBBBBBBBBADBL",
	"JBADBBBBBBBBBBBBBBBBBBBBBBADBL",
	"JBADBBBBBBBBBBBBBBBBBBBBBBADBL",
	"JBADBBBBBBBBBBBBBBBBBBBBBBADBL",
	"JBADBBBBBBBBBBBBBBBBBBBBBBADBL",
	"JBADBBBBBBBBBBBBBBBBBBBBBBADBL",
	"JBADBBBBBBBBBBBBBBBBBBBBBBADBL",
	"JBADBBBBBBBBBBBBBBBBBBBBBBADBL",
	"JBADBBBBBBBBBBBBBBBBBBBBBBADBL",
	"JBADBBBBBBBBBBBBBBBBBBBBBBADBL",
	"JBADBBBBBBBBBBBBBBBBBBBBBBADBL",
	"JBADBBBBBBBBBBBBBBBBBBBBBBADBL",
	"JBADBBBBBBBBBBBBBBBBBBBBBBADBL",
	"JBADBBBBBBBBBBBBBBBBBBBBBBADBL",
	"JBADBBBBBBBBBBBBBBBBBBBBBBADBL",
	"JBADBBBBBBBBBBBBBBBBBBBBBBADBL",
	"JBADBBBBBBBBBBBBBBBBBBBBBBADBL",
	"JBADBBBBBBBBBBBBBBBBBBBBBBADBL",
	"JBADBBBBBBBBBBBBBBBBBBBBBBADBL",
	"JBADBBBBBBBBBBBBBBBBBBBBBBADBL",
	"JBAMWWWWWWWWWWWWWWWWWWWWWWCDBL",
	"JBZSSSSSSSSSSSSSSSSSSSSSSSSVBL",
	"JBBBBBBBBBBBBBBBBBBBBBBBBBBBBL",
	"GKKKKKKKKKKKKKKKKKKKKKKKKKKKKH"],
  "entities": [
  	"BBBBBBBBBBBBBBBBBBBBBBBBBBBBBB",
	"BBBBBBBBBBBBBBBBBBBBBBBBBBBBBB",
	"BBTTTTTTTTTTTTaTTTTTTTTTTaTTBB",
	"BBTTTTTTTTTTTTbTTTTTTTTTTbTTBB",
	"BBghBBBBBBBBBBBBBBBBBBBBBBcdBB",
	"BBTTBBBBBBBBBBBBBBBBBBBBBBTTBB",
	"BBTTBBBBBBBBBBBBBBBBBBBBBBcdBB",
	"BBghBBBBBBBBBBBBBBBBBBBBBBTTBB",
	"BBTTBBBBBBBBBBBBBBBBBBBBBBcdBB",
	"BBTTBBBBBBBBBBBBBBBBBBBBBBTTBB",
	"BBTTBBBBBBBBBBBBBBBBBBBBBBTTBB",
	"BBghBBBBBBBBBBBBBBBBBBBBBBcdBB",
	"BBTTBBBBBBBBBBBBBBBBBBBBBBTTBB",
	"BBTTBBBBBBBBBBBBBBBBBBBBBBTTBB",
	"BBTTBBBBBBBBBBBBBBBBBBBBBBcdBB",
	"BBghBBBBBBBBBBBBBBBBBBBBBBTTBB",
	"BBTTBBBBBBBBBBBBBBBBBBBBBBTTBB",
	"BBTTBBBBBBBBBBBBBBBBBBBBBBTTBB",
	"BBTTBBBBBBBBBBBBBBBBBBBBBBcdBB",
	"BBghBBBBBBBBBBBBBBBBBBBBBBTTBB",
	"BBTTBBBBBBBBBBBBBBBBBBBBBBTTBB",
	"BBTTBBBBBBBBBBBBBBBBBBBBBBcdBB",
	"BBTTBBBBBBBBBBBBBBBBBBBBBBTTBB",
	"BBghBBBBBBBBBBBBBBBBBBBBBBTTBB",
	"BBTTBBBBBBBBBBBBBBBBBBBBBBTTBB",
	"BBTTBBBBBBBBBBBBBBBBBBBBBBcdBB",
	"BBTTTTTeTTTTTTTeTTTTTTeTTeTTBB",
	"BBTTTTTfTTTTTTTfTTTTTTfTTfTTBB",
	"BBBBBBBBBBBBBBBBBBBBBBBBBBBBBB",
	"BBBBBBBBBBBBBBBBBBBBBBBBBBBBBB"],
	"npcInstructions": [
  	"BBBBBBBBBBBBBBBBBBBBBBBBBBBBBB",
	"BBBBBBBBBBBBBBBBBBBBBBBBBBBBBB",
	"BBRREEEEEKEEEEEEEEEEEEEEEERRBB",
	"BBRREEEEEKEEEEEEEEEEEEEEEERRBB",
	"BBNNBBBBBBBBBBBBBBBBBBBBBBSSBB",
	"BBNNBBBBBBBBBBBBBBBBBBBBBBSSBB",
	"BBNNBBBBBBBBBBBBBBBBBBBBBBSSBB",
	"BBNNBBBBBBBBBBBBBBBBBBBBBBSSBB",
	"BBNNBBBBBBBBBBBBBBBBBBBBBBSSBB",
	"BBNNBBBBBBBBBBBBBBBBBBBBBBSSBB",
	"BBNNBBBBBBBBBBBBBBBBBBBBBBSSBB",
	"BBNNBBBBBBBBBBBBBBBBBBBBBBSSBB",
	"BBNNBBBBBBBBBBBBBBBBBBBBBBSSBB",
	"BBNNBBBBBBBBBBBBBBBBBBBBBBSSBB",
	"BBNNBBBBBBBBBBBBBBBBBBBBBBSSBB",
	"BBNNBBBBBBBBBBBBBBBBBBBBBBSSBB",
	"BBNNBBBBBBBBBBBBBBBBBBBBBBSSBB",
	"BBNNBBBBBBBBBBBBBBBBBBBBBBSSBB",
	"BBNNBBBBBBBBBBBBBBBBBBBBBBSSBB",
	"BBNNBBBBBBBBBBBBBBBBBBBBBBSSBB",
	"BBNNBBBBBBBBBBBBBBBBBBBBBBSSBB",
	"BBNNBBBBBBBBBBBBBBBBBBBBBBSSBB",
	"BBNNBBBBBBBBBBBBBBBBBBBBBBSSBB",
	"BBNNBBBBBBBBBBBBBBBBBBBBBBSSBB",
	"BBNNBBBBBBBBBBBBBBBBBBBBBBSSBB",
	"BBNNBBBBBBBBBBBBBBBBBBBBBBSSBB",
	"BBRRWWWWWWWWWWWWWWWWWWWWWWRRBB",
	"BBRRWWWWWWWWWWWWWWWWWWWWWWRRBB",
	"BBBBBBBBBBBBBBBBBBBBBBBBBBBBBB",
	"BBBBBBBBBBBBBBBBBBBBBBBBBBBBBB"]
}